111111111111111111111111111111
111000000C10000000000010000001
100001000000110000000100101C01
101000001010C00100001010100001
10000100C0000001000010C0100001
11000000101100100001C01E100001
10100000000C010001000000000001
1010C0010000000001000100100001
100000000101100000000P1C00C111
111111111111111111111111111111
