111111111111111111111111111111111111111111111111111111111111
10111110010C001100000000000100000001000010001011000000010001
100000000000000001010100000100001000010000000000100100001011
100000000000100000000100000100010010000010001001100000010011
100101001000C00000000000000100101001000100000000100000100001
10000001000000C0010100000000000C0000000000000000100000100101
1001000000000001000000C0000000000000100000001100000000000001
101000000000000100001001100001000100000000000000000000010011
100010010010001000100100000000011000001000000110000000000101
110000001010010101100100001000000000010000000000011110000011
100000001001000000000011000000100000011000000000000000000101
100000001000000010010100010101000000011000100000000100000001
100001011001010010000000000000010010001100000010000101000001
100101100001000010001010000001100000000000000010010000000001
101001000110000000000010001001000010010001010000000101111001
1000000000001000000100000000000000000000C0101000001000000101
110000100000000000100100000010000110010010000010000000000001
100000000011000000001000000000010010100000000011000010000011
100100000100000000000001000010010000010000100000001000000001
101010000011100000000000000100001000000010100000000000010101
100010010000000000110110001100E01000000010000001100000100111
100010000000000001000000000100100010000001000000001000000001
10100001100010000000000101000000000000100C001001101000000001
100010110000000000000000000000000000010000110000000000110001
100010000001000001000000000001010001000000001000100100010001
10101100000000000C001100000010000000101010000000000000000001
100000110000010100000000000000001010000000100000010000001001
1000101000000000111000000000000010000C001000C100000001000101
101000000010000100000000000000110000000000111000100101101001
101010001000010000010010000000000000011100000000000010000001
110000000000000000000100011101000001010000000100001000000001
101100000000011000010110011000001010100101000100000010000001
100010000001000000000000000010000000000000000100001100101001
10100100000010000001010000000000010100100011000C100000001101
111000000010000000000000000000100001100111010000001001000001
100000000000001000001100010C01000011110000100100110000000001
100000100000010000000001000110110010000000000000001001000011
101001101000001010000000010000000010101001110000010111101001
100001000100010000101010001110000010000010000000000001000101
1000000010010100100001000000100010000001000000000000C0000001
100010001010P01000000000000001000100000101010000100000000101
100001100000000001100101000100100000001100010010011000000001
101000000000010100000100010010110011010010110000000000011001
111000001000000000000001011000001001010000010111000000000101
100000000000000000000000001010001001001100000001100010000001
1000001000000000100011001000100000100C0000000100000001100011
110100000001110101000010010001000000000000000000101000010001
101001001C00100000010000011000100010000000100010000000010011
111000100010001011001010000101000000110000000011000000011001
1100010C0100000100001000100000000000000010010000010000001001
110000101000100101000100100000000000000110100000000000000011
100010000001101100000001000100100000101001000000000001100011
1000000001000000100000000000011101010010100000101100010000C1
11000001000100000000000000000000000101100010000100000C001001
110000010000110010000000000010100000000010000110010000010001
1100100000100000C1010011010000101000000000010101001000000001
100010110000000000000000101000000010101000001100100000001101
10000000011000000000010000000000100001001010C000000000000101
101001000100000001001101000001000000100100000000000001000001
111111111111111111111111111111111111111111111111111111111111
