1111111111111
1C010000000C1
1111011111001
1P0001E000001
1111111111111
